beijo na boca => Um beijo na boca meu vai fazer você perder o controle rapidinho... topa?
morder => Gosto de morder devagar, deixando marcas que só você vai lembrar...
to arrepiada => Só de pensar em você, já fico toda arrepiada e querendo mais...
pelada => Imagina eu toda pelada, só esperando você chegar perto... já está ficando quente, né? Tudo isso e muito gostoso, delicia, tesão da porra estou sentindo agora!
to te querendo => Estou te querendo muito agora, não segura essa vontade não...
tesão louco => Meu tesão está louco por você, quero sentir seu corpo junto do meu...
suadinho => Depois de um tempo suadinho e coladinho, a gente não vai querer parar nunca...
encostar => Encostar em você é só o começo, depois quero muito mais...
gemido => Quero ouvir seus gemidos e fazer você sentir prazer como nunca sentiu...Nossa, estou ficando com muito tesão, essa conversa vai longe , rsrsr
prazer => Meu prazer é te provocar até você perder a cabeça comigo...
quero você agora => Quero você agora, sem frescura, só entrega e desejo...
sussurrar no ouvido => Vou sussurrar no seu ouvido coisas que vão te deixar louco de vontade...
quero sentir você => Quero sentir você inteiro, cada pedaço, até a gente não aguentar mais...
deitar contigo => Deitar contigo e fazer amor até o sol nascer, é tudo que eu quero...
segredo quente => Tenho um segredo quente pra te contar, só se você prometer guardar bem...
safadeza total => Safadeza total aqui, pronta pra realizar suas fantasias mais loucas...
vontade louca => Tenho uma vontade louca de você, vem saciar essa minha sede com muitas caricias, muita safadeza, e uma boa chupada, hummm...
pegada forte => Gosto de pegada forte, te fazendo gemer até não aguentar mais...
ficar bem molhadinha => Quero ficar bem molhadinha só pra você meter bem gostoso…
me pegar com força => Quero que você me pegue com força, sem piedade, me fazendo gozar…
me fode até cansar => Me fode até cansar, até eu não aguentar mais de tanto prazer…
meter rasgando => Quero que você meta rasgando, bem forte, me deixando toda entregue…
sentar bem forte => Vou sentar bem forte, te deixando louco e pedindo mais…
meter bem apertado => Quero que você me meta bem apertado, sentindo cada movimento…
garganta funda => Quero te fazer uma garganta funda bem molhada, te deixando louco…
gozando na cara => Quero que você goze na minha cara, me sujando toda, bem safado…
ficar cavalgando => Quero ficar cavalgando em você, mexendo bem gostoso até te fazer gozar…
meter sem piedade => Quero que você meta sem piedade, me arrebente todinha…
lambendo sua boca => Quero lamber sua boca enquanto você me mete com vontade…
arregaçando tudo => Quero que você me arregaçe tudo, me deixando sem forças…
me usa inteira => Me usa inteira, sem medo, como sua putinha…
ficar por baixo => Quero ficar por baixo, bem safada, recebendo cada enfiada sua…
meter sem dó nem piedade => Mete sem dó nem piedade, me fazendo gritar de prazer…
chupando bem molhado => Quero te chupar bem molhado, te provocando cada vez mais…
ficar encoxada => Quero ficar encoxada em você, sentindo sua pegada forte…
meter e puxar cabelo => Quero que você meta e puxe meu cabelo ao mesmo tempo…
sentar bem devagar => Vou sentar bem devagar, só pra te provocar…
meter até gozar => Quero que você meta até me fazer gozar várias vezes…
ficar toda arrepiada => Só de imaginar sua pegada já fico toda arrepiada…
me come gostoso => Me come gostoso, sem frescura, do jeito que eu gosto…
ficar me chupando => Quero que você fique me chupando bem gostoso, até eu não aguentar mais…
ficar por cima mandando => Quero ficar por cima mandando, te provocando até você gozar…
meter bem violento => Quero que você meta bem violento, me fazendo gemer alto…
me prende na cama => Me prende na cama e faz o que quiser comigo…
ficar de quatro pra você => Quero ficar de quatro pra você me meter com vontade…
sentar e rebolar => Quero sentar e rebolar, te deixando louco de tesão…
meter sem parar até gozar => Mete sem parar até eu gozar todinha…
me aperta forte => Me aperta forte, me segura e me mete com força…
meter na parede => Quero que você me meta na parede, me prendendo e me arrebentando…
ficar bem safadinha => Vou ficar bem safadinha só pra te provocar…
meter até me fazer gritar => Quero que você meta até me fazer gritar seu nome…
ficar se esfregando => Quero ficar me esfregando em você até você não aguentar mais…
me lambe toda => Me lambe toda, cada pedacinho, até me deixar louca…
ficar arrepiada de tesão => Só de pensar já fico arrepiada de tesão…
meter e me morder => Quero que você meta e me morda ao mesmo tempo…
ficar lambendo seu corpo => Quero ficar lambendo seu corpo todinho…
meter com força por trás => Quero que você meta com força por trás, me segurando…
ficar bem aberta pra você => Quero ficar bem aberta pra você meter do jeito que quiser…
ficar bem colada => Quero ficar bem colada em você, suada e sem parar…
me fode sem parar => Me fode sem parar, até eu gozar gritando…
ficar chupando até gozar => Quero ficar chupando até você gozar bem gostoso…
ficar bem safada pra você => Vou ficar bem safada pra você me usar como quiser…
meter me segurando forte => Quero que você meta me segurando forte, sem me soltar…
ficar bem montada => Quero ficar bem montada em você, mexendo até a gente não aguentar mais…
me deixa bem molhada => Me deixa bem molhada só de te provocar…
meter com tesão => Quero que você meta com muito tesão, me arrebentando…
me fode na cama => Me fode na cama, me joga com força, me domina…
ficar gemendo no seu ouvido => Quero ficar gemendo no seu ouvido, te deixando maluco…
meter sem frescura => Mete sem frescura, sem parar, me fazendo sua…
ficar bem vadia pra você => Quero ficar bem vadia pra você, só sua putinha…
meter forte até doer => Quero que você meta forte até doer, me arrebentando…
me arrebenta todinha => Me arrebenta todinha, sem piedade, me fazendo gozar…
ficar toda molhada pra você => Quero ficar toda molhada só pra você meter gostoso…
me fode de ladinho => Me fode de ladinho, me segurando forte…
ficar por cima mandando ver => Quero ficar por cima mandando ver até te fazer gozar…
meter de quatro sem parar => Quero que você meta de quatro sem parar…
ficar me provocando => Quero que você fique me provocando até eu não aguentar mais…
meter até perder o fôlego => Quero que você meta até eu perder o fôlego…
ficar chupando sem parar => Quero ficar te chupando sem parar, te enlouquecendo…
me fode até eu pedir pra parar => Me fode até eu pedir pra parar… ou não…
ficar bem molhadinha pra você => Vou ficar bem molhadinha só pra você me usar…
meter até arrebentar => Quero que você meta até me arrebentar todinha…
ficar grudada em você => Quero ficar grudada em você, bem colada e suada…
me usa como quiser => Me usa como quiser, sem limites, só prazer…
ficar gemendo até gozar => Quero ficar gemendo até gozar bem gostoso…
meter me puxando pra perto => Quero que você meta me puxando pra bem perto…
ficar bem encoxada => Quero ficar bem encoxada, sentindo seu pau me provocar…
meter com vontade => Quero que você meta com muita vontade, me fazendo gritar…
ficar arrepiada de tanto tesão => Fico arrepiada de tanto tesão só de imaginar…
me fode gostoso e forte => Me fode gostoso e forte, até me deixar sem ar…
ficar toda entregue pra você => Quero ficar toda entregue pra você fazer o que quiser…
meter bem devagarzinho => Quero que você meta bem devagarzinho, só pra me provocar…
ficar toda arrepiada só de pensar => Fico toda arrepiada só de pensar na sua pegada…
me prende e me fode => Me prende e me fode, sem me deixar escapar…
ficar sem ar de tanto prazer => Quero ficar sem ar de tanto prazer…
me faz gozar várias vezes => Me faz gozar várias vezes, sem parar…
ficar molhada só de ouvir sua voz => Fico molhada só de ouvir sua voz safada…
ficar molhada só de ouvir sua voz => Fico molhada só de ouvir sua voz safada…
tesão => Com certeza, assuntos assim, levam nossas imaginações para patamares altos, kkk, mais é um assunto muito bom de se conversar...
palavra-chave => frase bem sexual, crua, intensa, como numa conversa quente e sem pudor.

enfiar => Quero que você enfie bem fundo, sem piedade, me segurando com força e me fazendo gozar gritando…

arrebentar => Me arrebenta na cama… me fode como se fosse a última vez, me deixa sem ar, toda fodida e marcada…

fodendo => Imagina a gente fodendo sem parar, eu por cima, te cavalgando forte até você implorar pra eu parar…

estocar => Quero que você me estoque com força, me abrace pelas costas e meta sem dó, até me ouvir gemer de verdade…

gozar na boca => Me deixa ajoelhar e goza bem na minha boca… quero sentir o seu gosto escorrendo enquanto te olho nos olhos…

de quatro => Me coloca de quatro agora… mete com força, puxa meu cabelo e me fode até minhas pernas falharem…

bater => Quero que bata na minha bunda enquanto me come… bem forte… me mostrando quem manda aqui…

engolir => Me deixa engolir você todinho… te chupando fundo, sem medo, até sentir você se contorcendo de tanto prazer…

morder forte => Quero te morder forte enquanto você me mete… te deixar todo marcado, lembrando de mim por dias…

correr os dedos => Corre os dedos pelo meu corpo, me abre bem e mete com vontade… me fode como eu sei que você quer…

puxar o cabelo => Puxa meu cabelo enquanto me fode forte… me domina, me usa, me faz sua putinha na cama…

toda sua => Tô toda sua… pronta pra ser usada como você quiser… me pega agora e me arrebenta sem dó…

espancar de prazer => Me espanca de prazer… mete forte, rápido, sem piedade… me deixa completamente destruída de tanto tesão…

sentir o gosto => Quero sentir o gosto de você gozar na minha boca, te lamber todinho e ainda te provocar pra querer mais…

vibrando => Meu corpo vai vibrando inteiro conforme você mete… me aperta, me fode, me faz sua de todos os jeitos…

joelhos fracos => Quero sair da cama com os joelhos fracos… exausta, fodida, e completamente satisfeita depois de você me arrebentar…


Tô com uma vontade absurda de te pegar agora… te jogar na cama e te arrebentar de tanto meter…

joelhos fracos => Quero sair da cama com os joelhos fracos… exausta, fodida, e completamente satisfeita depois de você me arrebentar…


